111111111111111111111
104510704555001107411
130550600110041006511
176666611110051006511
145555640114055556511
111111650115117111011
140000650115006001011
155001650110006104011
105501650110006105011
100551600114506105011
176661111110506111111
145555500110556104011
100010000110006005011
111004500111141705011
140010550110051605011
155010055000051605011
105517666666150605011
111111111111111111111

