1111111111111111111111111111111
1000107045550010700000455555501
1000006001100010600111111000551
1766666111100010600114501000001
1000006401140000600110545555551
1111716501151111111114000011111
1400606501150000070115550000001
1550616501100001060110055100001
1055616501100001060114000100001
1005616001100001060005550100001
1300111111100001111111111111111
1455555071145551040114555550001
1000100061100017050000001766661
1110045061111016050111111000001
1740105561100416050114555555551
1655100561100516050110001111111
1605176661100506050114555555551
1600100061111111111111111000001
1645100064550017000110071766661
1605100060050006000110060000001
1111111111150006111110060011111
1007045550050006000110060040001
1406010055050001000110060155001
1506010005500001000110060105501
1556010000500001000110060100551
1056011111111111111110010111111
1056011111111111111114555557001
1056176666666614500000001006001
1116145001140010550111101006001
1006105501155010055110001006001
1006000501105500005110001006001
1111111111111111111111111111111