1111111111
1000100001
1000166671
1000100001
1000000001
1000001111
1000000001
1000010001
1000010301
1000010001
1000011111
1000000001
1000100001
1110100001
1000100001
1000100001
1111111111