111111111111111111111
100010000555001100011
100000600113001000011
100000600110001000011
100000040114000000011
111111050115111111011
104000050115000001011
105501050110000104011
100551050110000105011
100051000110000105011
100001111110000111111
145555500114555104011
100010000110000005011
111004500111141005011
140010550110051005011
155010055000051005011
105510000000150005011
111111111111111111111