1111111111111111111111111111111
1000107045550010000000000000001
1300006001100010000111111000001
1766666111100010000114501000001
1000006401140000000110545555551
1111116501151111111114000011111
1040006501150000000115550000001
1055016501100001000110055100001
1005516501100001000114000100001
1000516001100001000005550100001
1000011111100001111111111111111
1455555001145551040114555550001
1000100001100010050000001766661
1110045001111010050111111000001
1000105501100410050114555555551
1000100501100510050110001111111
1000100001100500050114555555551
1000100001111111111111111000001
1000100004550010000110001000001
1000100000050000000110000000001
1111111111150000111110000011111
1000045550050000000110000000001
1400010055050001000110000100001
1500100055000010001100001000001
1550010000500001000110000100001
1050011111111111111110010111111
1050011111111111111114555550001
1050100000000014500000001000001
1110145001100010550111101000001
1000105501100010055110001000001
1000000501100000005110001000001
1111111111111111111111111111111