1111111111111111111111111111111
1000100000000010000030000000001
1000060001100010666111111066661
1000060001100010000114501000001
1000060401140000000110545555551
1111110501151111111114000011111
1040000501150666666115550000001
1055010501100001000110055100301
1005510501100001000114000100001
1000510001100001000005550100001
1000011111100001111111111111111
1455555001145551040114555550001
1000100001100010050000001000001
1110045001111010050111111000001
1000105501100410050114555555551
1000100501100510050110001111111
1000100001100500050114555555551
1111111111111111111111111111111