111111111111111111111
100010070000001100011
100000060113001000011
100000060110001000011
176666666114000000011
111111040115111111011
104000050115000001011
105501050110000104011
100551050110000105011
100051000110000105011
100001111110000111111
145555500114555104011
100010000110000005011
111004500111141005011
100010550110051005011
100010055000051005011
145510000000150005011
111111111111111111111